{
  "name": "#--Bosquet Lividus--#",
  "level" : [
      [{"🟩" : "w"},{"🌳" : "b"},{"🟩" : "w"},{"🟩" : "w"},{"🔺" : "go/bosquet-lividus/4/7"},{"🟩" : "w"},{"🟩" : "w"},{"🟩" : "w"},{"🟩" : "w"},{"🟩" : "w"},{"🌳" : "b"},{"🟩" : "w"},{"🟩" : "w"}],
      [{"🌳" : "b"},{"🟩" : "w"},{"🌲" : "b"},{"🌲" : "b"},{"🟩" : "w"},{"🟩" : "w"},{"🟩" : "w"},{"🌲" : "b"},{"🟥" : "b"},{"🟩" : "w"},{"🌳" : "b"},{"🌲" : "b"},{"🟩" : "w"}],
      [{"🟥" : "b"},{"🟩" : "w"},{"🟥" : "b"},{"🌲" : "b"},{"🟩" : "w"},{"🟩" : "w"},{"🟥" : "b"},{"🟥" : "b"},{"🟥" : "b"},{"🟥" : "b"},{"🌳" : "b"},{"🟥" : "b"},{"🌲" : "b"}],
      [{"🪨" : "b"},{"🟩" : "w"},{"🟥" : "b"},{"🟫" : "w"},{"🟫" : "w"},{"🟫" : "w"},{"🟥" : "b"},{"🪨" : "b"},{"🟥" : "b"},{"🟥" : "b"},{"🟥" : "b"},{"🔥" : "b"},{"🌲" : "b"}],
      [{"🟥" : "b"},{"🟥" : "b"},{"🟥" : "b"},{"🟫" : "w"},{"🟫" : "w"},{"🟫" : "w"},{"🟥" : "b"},{"🟥" : "b"},{"🟥" : "b"},{"🪨" : "b"},{"🟥" : "b"},{"🟥" : "b"},{"🟥" : "b"}],
      [{"🔥" : "b"},{"🔥" : "b"},{"🔥" : "b"},{"🟫" : "w"},{"🟫" : "w"},{"🟫" : "w"},{"🟥" : "b"},{"🟥" : "b"},{"🟥" : "b"},{"🟥" : "b"},{"🟥" : "b"},{"🟥" : "b"},{"🟥" : "b"}],
      [{"🔥" : "b"},{"🌋" : "b"},{"🔥" : "b"},{"🟫" : "w"},{"🟫" : "w"},{"🟫" : "w"},{"🟥" : "b"},{"🟥" : "b"},{"🟥" : "b"},{"🔥"  : "b"},{"🟥" : "b"},{"🪨" : "b"},{"🟥" : "b"}],
      [{"🔥" : "b"},{"🔥" : "b"},{"🔥" : "b"},{"🟫" : "w"},{"🟫" : "w"},{"🟫" : "w"},{"🔥" : "b"},{"🟥" : "b"},{"🟥" : "b"},{"🟥" : "b"},{"🟥" : "b"},{"🟥" : "b"},{"🟥" : "b"}],
      [{"🟥" : "b"},{"🟥" : "b"},{"🟥" : "b"},{"🟫" : "w"},{"🔻" : "go/salle1/4/1"},{"🟫" : "w"},{"🟥" : "b"},{"🟥" : "b"},{"🟥" : "b"},{"🟥" : "b"},{"🟥" : "b"},{"🟥" : "b"},{"🟥" : "b"}]
  ]
}